1111111111111
100C000E000C1
100C00000C101
1P00110C10011
1111111111111