1111111
1P01001
101C1E1
1000001
1111111