1111111111111
100C000E000C1
100C00011C101
1P00110C00011
1111111111111