1111111111111
1001000E000C1
1000001111101
1P00110100011
1111111111111