11111111111111
1000000P010001
10001001C10011
10001C001000C1
110E0000000101
11111111111111
