111111111111111111111
1P0000000000010000001
100011111101011110001
100C00000000000000C01
101111011111110111101
10000001C0000C0000001
111101111111111101111
1C00001000000001000C1
101111011101110111101
1000000C001000C000001
111101111111111101111
1E0000100000000100001
111111111111111111111