111111111111111111111
100000000P00000000001
100000000000000000001
100101111011110111101
100100001000010000101
100101111011110000101
100100001000010000101
100101111011110000101
100000000E0C000000001
111111111111111111111